X X X X X X X X X X X X X X X X X X X X X X X X
X O O O O O O O O O O O O O O O O O O O O O O X
X O X X X X X X X X O X X O X X X X X X X X O X
X O X O O O O O O X O X X O X O O O O O O X O X 
X O X O X X X X X X O X X O X X X X X X O X O X
X O X O X O O O O O O X X O O O O O O X O X O X
X O X O X O X X X X O X X O X X X X O X O X O X
X O X O X O X G O O O X X O O O O X O X O X O X					   
X X X O X O X X X X O X X O X X X X O X O X O X					   
X O O O O O O O O O O X X O O O O O O O O O O X					   
X O X X X X X X X X X X X X X X X X X X X X O X					   
X O O O O O O O O O O X X O O O O O O O O O O X					   
X O X O X O X X X X O X X O X X X X O X O X O X					   
X O X O X O X O O O O X X O O O G X O X O X O X					   
X O X O X O X X X X O X X O X X X X O X O X O X					   
X O X O X O O O O O O X X O O O O O O X O X O X					   
X O X O X X X X X X O X X O X X X X X X O X O X					   
X O X O O O O O O X O X X O X O O O O O O X O X					   
X O X X X X X X X X O X X O X X X X X X X X O X					   
X O O O O O O O O O O X X O O O O O O O O O O X					   
X O X X X X X X X X O X X O X X X X X X X X X X					   
X O X X X X X X X X O X X O X X X X X X X X O X					   
X P O O O O O O O O O O O O O O O O O O O O O X					   
X X X X X X X X X X X X X X X X X X X X X X X X